filename, language, Dart, comment, blank, total
/Users/fatboy/Documents/flutter projects/e_commerce/lib/add2cart.dart, Dart, 30, 0, 4, 34
/Users/fatboy/Documents/flutter projects/e_commerce/lib/addNotification.dart, Dart, 25, 0, 2, 27
/Users/fatboy/Documents/flutter projects/e_commerce/lib/descpage.dart, Dart, 439, 0, 23, 462
/Users/fatboy/Documents/flutter projects/e_commerce/lib/getuserdata.dart, Dart, 404, 0, 20, 424
/Users/fatboy/Documents/flutter projects/e_commerce/lib/login.dart, Dart, 244, 0, 16, 260
/Users/fatboy/Documents/flutter projects/e_commerce/lib/main.dart, Dart, 68, 0, 11, 79
/Users/fatboy/Documents/flutter projects/e_commerce/lib/myNotifications.dart, Dart, 178, 0, 13, 191
/Users/fatboy/Documents/flutter projects/e_commerce/lib/myaccount.dart, Dart, 564, 0, 18, 582
/Users/fatboy/Documents/flutter projects/e_commerce/lib/mycart.dart, Dart, 312, 0, 13, 325
/Users/fatboy/Documents/flutter projects/e_commerce/lib/notifdesc.dart, Dart, 85, 0, 8, 93
/Users/fatboy/Documents/flutter projects/e_commerce/lib/products.dart, Dart, 733, 1, 30, 764
/Users/fatboy/Documents/flutter projects/e_commerce/lib/register.dart, Dart, 283, 0, 11, 294
/Users/fatboy/Documents/flutter projects/e_commerce/lib/scanToSearch.dart, Dart, 223, 0, 9, 232
Total, -, 3588, 1, 178, 3767